###################
#.................#
#.................#
D........!........#
#........!........#
#........!........#
#........!........#
#........!!!!.....#
#.................#
###################