########################
#...*..*...............D
#......*.*.*...........#
#...*..*.*.*...........#
#****..*.*.*...........#
#...*..***.*...........#
#......*.*.*...........#
#..*****.*.*...........#
#........*.............#
#******................#
#......................#
#......................#
########################