########################
#......................#
#......................#
#......................#
#......................#
#......................#
#..........*...........#
#......................#
#......................#
#......................#
#......................#
#......................#
########################