###################
#.................#
#.................#
#........!!!!.....#
#........!........#
#........!!!!.....#
D........!........#
#........!........#
#.................#
###################