########################
#......***....*.....*..#
#**.......*......*..*..#
#.....**.**.***........#
#..**.....**...*.**....#
#########.*..*......*..#
#.........*.############
#########.*....*.....*.#
#...**....*.**...****..D
#**.**..*.....***..**.*#
#.*......****.......*..#
#.*...**....*..*.**....#
########################