###################
#.................#
#.................#
#........!!!!.....D
#........!........#
#........!!!!.....#
D........!........#
#........!........#
#.................#
###################