##########
#........#
#........#
#...###..D
#.....#..#
#.....#..#
#####D####