########################
#.*...*...*...*...*...*#
#...*...*...*...*...*..#
#.*...*...*...*...*...*#
#...*...*...*...*...*..#
#.*...*...*...*...*...*#
#...*...*...*...*...*..D
#.*...*...*...*...*...*#
#...*...*...*...*...*..#
#.*...*...*...*...*...*#
#...*...*...*...*...*..#
D.*...*...*...*...*...*#
########################