########################
#......................#
#......................#
#......................#
#......................#
#......................#
D......................#
#......................#
#......................D
#......................#
#......................#
#......................#
########################