########################
#.#.......#.........##.#
#.#####.#.#..######....#
#.#.....#.#..#....###..#
#.#.########...#######.#
#.#......#.....#...#.#.#
#.#.#....#.#####.#.#.#.D
#.#.#....#.......###.#.#
#.#.####.######..#...#.#
#......#..#...#..#...#.#
#.####.####.#.####...#.#
#.#..#......#..........#
########################