########################
#*........*............#
#.........*......*.....#
#..*......*......*.....#
#...*.....*......*.....#
#....*....*......*.....#
#.....*...*......*.....#
#......*.........*.....#
#.......*#############.#
#........#.............#
D........#.............#
#........#.............D
########################