########################
#.*...*...*...*...*...*#
#...*...*...*...*...*..#
######################.#
#*...*...*...*...*...*.#
#..*...*...*...*...*...#
#.######################
#.......*..............#
#.......*...*..........#
#.......*...*.....**.**#
#...........*.....*....D
#.......*...*.....*....#
########################