########################
#...*..*......****.....D
#......*.*.*...........#
#...*..*.*.*****.*.....#
#****..*.*.*.....*.....#
#...*..***.*.....*.....#
#......*.*.**.*********#
#..*****.*.*...*.......#
#........*****.........#
#******..*...*********.#
#.......**.*.*.........#
#..***.....*...*.......#
########################