########################
#......**.....*.....*..#
#**.......*......*..*..#
#.....**.**.***........#
#..**.....**...*.**....#
#********.*..*......*..#
#.........*.***********#
#********.*............#
#...**....*.**********.D
#**.**..*.*...**...**.*#
#.*......****.......*..#
#.*...**.......*.**....#
########################