########################
D.*...*..*...*...*...*.#
#...*..*...*...*...*...#
######################.#
#.*...*..*...*...*...*.#
#...*..*...*...*...*...#
#.######################
#.......*..............#
#.......*...*..........#
#.......*...*.....**.**#
#...........*.....*....D
#.......*...*.....*....#
########################