########################
#......***....*.....*..#
#**.......*......*..*..#
#.....**.**.***........#
#..**.....**...*.**....#
#********.*..*......*..#
#.........*.***********#
#********.*....*.....*.#
#...**....*.**...****...D
#**.**..*.....***..**.*#
#.*......****.......*..#
#.*...**....*..*.**....#
########################