########################
#.#.......#.........##.#
#.#####.#.#..######....#
#.#.....#....#....###..#
#.#.########...##....#.#
#.#......#.....#...#.#.#
#.#.#....#***###.#.#.#.D
#.#.#....#.......###.#*#
#.#.####.######..#...#.#
#......#..#...#..#...#.#
#.####.####.#.####...#.#
#.#..#......#..........#
########################
