#####D####
#........#
#........#
#........#
#..###...#
#........#
##########