########################
#......................#
#......................#
#......................#
#......................#
#......................#
#.................*....#
#......................#
#......................#
#......................#
#......................#
#......................#
########################