###################
#......*..........#
#......*...*......#
#......*...*!.....#
#****..*...*......#
#......*...*......#
#......*.!.*......D
#..*****...*......#
#..........*......#
###################