########################
#...*..*...............#
#......*.*.*...........#
#...*..*.*.*...........#
#****..*.*.*...........#
#...*..***.*...........#
#......*.*.*...........D
#..*****.*.*...........#
#........*.............#
#******................#
#......................#
#......................#
########################