###################
#.................#
#.................#
#...........!.....#
#.................#
#.................#
#........!........D
#.................#
#..........*......#
###################