########################
#......................#
#......................#
#......................#
#......................#
#......................#
#......................D
#......................#
#......................#
#......................#
#......................#
D......................#
########################